##############
# p          #
#            #
#------  ----#
#     # -#
#     # ###################################
#     #                                   #
#     #---------------------------------- #
#                                       # #
#         --------                      # #
#         #       -                     # #
#         #        -                    # #
#         #         -                   # #
#         #          -                  # #
#         #           -                 # #
#         #            -                # #
#         #             -               # #
#         #              -              # #
#         #               -             # #
#         #                -            # #
#    T    #                 -             #
#         --------------------------------#
