###############################################
#                                             #
#p                                            #
#                                             #
#                                            T#
#--tttttttttttttttttttttttttttttttttttttttt---#
#                                             #
#                                             #
#                                             #
#                                             #
#                                             #
#                                             #
#                                             #
#                                             #
#                                             #
#                                             #
#                                             #
#                                             #
#                                             #
#                                             #
#                                             #
#                                             #
#                                             #
#                                             #
#                                             #
#                                             #
#                                             #
#                                             #